111111111111111111111
1n00C001C100000000001
1000000001000E0000001
100C00000000000000n01
10000000C0000P0000C01
111111111111111111111
