1111111111111111111111111111111111111
1000001C10000000000010000000C0C000001
1000C00000C000000C0011100C00000000001
10000000000000000000000C0000000000001
10C0C00000000010000P00000000E0000C001
1111111111111111111111111111111111111
